Dark Citadel
20 20
####################
#..~...........~...#
#..#....T...#......#
#.....#....#.......#
#..#........#..~...#
#......~...........#
#..#........#......#
#.....#..T..#......#
#..#........#......#
#......#...........#
#......C......~....#
#..~...#...........#
#..#........#......#
#.....#....#...T...#
#..#........#......#
#.....~............#
#..#........#..~...#
#.....#....#.......#
#..#...~....#......#
####################

