Frost Peaks
20 20
####################
#..M.......M....M..#
#...M...T....M.....#
#......WWW.........#
#.T....W.W.......M.#
#......WWW...~.....#
#...M........M.....#
#..................#
#.~......M.........#
#........M......T..#
#....M.............#
#.........T........#
#...M........M.....#
#......~...........#
#..T...............#
#........M....M....#
#..M...............#
#......M.....~.....#
#.............M....#
####################

