Scorched Dunes
20 20
####################
#DDDDDDDDDDDDDDDDDD#
#DD~DDDDDDDTDDDDDDD#
#DDDDDDDDDDDDDDDDDD#
#DDDDDDDDDDDDDDD~DD#
#DDTDDDDDDDDDDDDDD#
#DDDDDDD~DDDDDDDDDD#
#DDDDDDDDDDDDDDDDDD#
#DDDDDDDDDDDDTDDDDD#
#DD~DDDDDDDDDDDDDDD#
#DDDDDDDDDDDDDDDDDD#
#DDDDDTDDDDDDD~DDDD#
#DDDDDDDDDDDDDDDDDD#
#DDDDDDDDDDDDDDDDDD#
#DDD~DDDDDDDDDDDDDD#
#DDDDDDDDTDDDDDDDDD#
#DDDDDDDDDDDDDD~DDD#
#DDDDDDDDDDDDDDDDDD#
#DDDDDDDDDDDDD~DDDD#
####################

