Verdant Woods
20 20
####################
#....W.......F.....#
#.F.WWW..T...FF....#
#...W......F.......#
#......F...........#
#.T.....~....F.....#
#.F........F.......#
#.....F..........T.#
#........F...W.....#
#.....T....WWW.....#
#..F.......W....~..#
#.....F............#
#.F...........F....#
#.F........F.......#
#......~...........#
#...F........F.....#
#.........T........#
#..F...............#
#..................#
####################

